#################################I###
###....#.....#......###...#...#...#.#
#...##...###...####.....#..##.#.##..#
#.#########.###....##.####.##.#.#..##
#.............##.######..#......#...#
#####.#.###.#..........#.######.###.#
#F..........###.#.#.##..............#
#####################################
