#####################################
I.....###.....##....................#
#####.....###....##################.#
#########.###########....#....#####.#
##.....##.......#####.##...##.#####.#
##.###.########.......#######.#####.#
##.###.######################.#####.#
##.###........................#####.#
##.################################.#
##.##############F#################.#
##......#########...................#
##.####....##.....#################.#
##.#######....###.#################.#
##.##############.#################.#
##................#################.#
#####################################