#####################################
I.....###.....##....................#
#####.....###....##################.#
#########.###########....#....#####.#
##.........................##.#####.#
##............................#####.#
##............................#####.#
##............................#####.#
##...............#............#####.#
##.##############F#################.#
##......#########...................#
##.####....##.....#################.#
##.#######....###.#################.#
##.##############.#################.#
##................#################.#
#####################################