#I######
#.######
#..#####
##.#####
##.....#
######.S